111111111111111111111111111111111111
100000000000000000000000000000000111
111001010010000010100100000001010111
111111001010101000100100000001011111
1EP0000000C00C0000000000000000000001
111111111111111111111111111111111111