1111111111111111111111111111111111111
1000000000000000000000000000000001111
1111111111010101110110111111111101111
1111110010101010101001000001011111111
1E0P000000C00C00000000000000000000011
1111111111111111111111111111111111111