111111
11C111
1000E1
1P1111
111111