11111111111111111
10000000001111111
100CPE00001111111
11111111111111111