11111111111111111111111111111111111111111111111111111111111111
10000000000000000000000000000001100000000000000000000000000001
100CP0011000000000000000000000000000000000000000C0000000000001
100000011000000000000000000000011000000000000000N0000000000001
1000000110000000000000C000000N01100000000000000000000000000001
10000001100000000000C0011111111C111111111111111111111111111111
100000011000000000C0000110000000000010000000000000000000000001
1000000110000000C000000110000000000010000000000000000000000001
1000000110000000C000000110000000C0001C000000000000000000000001
10000001100000C00000000NN00000C000NC10C00000000000000000000001
10000001100000010000000110000000000000000000000000000000000001
100000000000000E1000000000000000000010000000000000000000000001
11111111111111111111111111111111111111111111111111111111111111